------------------------------------------------------------------------------------------------------------------------
------------------------------------------------------------------------------------------------------------------------
-XXXX-----------------SSSSSSSSSSSSSSS>S------------------------------------------------------------E--------------------
--[]------------------SSSSSSSS-------[]------------------------------------------------------ooo--<>--------------SSSSSS
--[]---------E--------SSSSSSSS-------Q]------------------------------------------------------ooo--[]--------------------
--<>--------<>--?QQQQ-SSSSSSSS-------[]---------------------------------X---XX-----X--------XXXXX[[]X-------------------
-----------X[]----[<-----------------[]----]E-E-E------------S-------------------------------------]----------------]E--
---E------XX[]----<]-----------------[]----<><><>-------------------------ooooooo-----------------------------------<>--
---------EXXo]----]<-----------------[]----[][][]-------------------------ooooooo----------------------------------->][-
--------<>XX[?--S-<>-----]<><E-------[]----QQQQ]Q-------------------E-----------E-----------------------------------[]--
-----E-X[]XX[]--------XXX-[]?]------]<>-------------------Q--------<>---------[[>-----E-----E----------------------?<SS-
----<>XX[]]X[]-----E--XXX-[][]------------------------<E------<----<]-----E----[]----<>----<>---------------------------
----[]XX[]XX[<-----E--XXX][][]------------------------<>------[]---[?----<>----[]----[]----[]---------------------------
----[]XXXXXXXXXXX]<>-XXXX-XXXXXXEXXXXXXX--------------[]------[]--][E>---[]<---[]---X[]X--X[?XXX---------E-E--]E--------
----[]XXXXXXXXXXXX[]-XXXX-XXXXXXXXXXXXXX---XXXXXXXXXXXXXX-XXX-XX--XXXXX--[]----o]---------------------XX<>XXXX<-XXX----X
----[]<XXXXXXXXXXXo]-XXXX-XXXXXXXXXXXXXX---XXXXXXXXXXXXXX-XXX-XX--XXXXX-->]----[]---------------------XX<[<XXX<>XXX----X