------------------------------------------------------------------------------------------------------------------------
------------------------------------------------------------------------------------------------------------------------
-XXXX-----------------SSSSSSSSSSSSSSSS]------------------------------------------------------------E--------------------
--[>------------------SSSSSSSS-------S]------------------------------------------------------ooo--]?--------------SSSSSS
-<]]-------->E--------SSSSSSSS-------[]------------------------------------------------------ooo--E]]-------------------
--<>--------<>[-?QQQQ-SSSSSSSS-------[o---------------------------------X---XX-----X--------XXXXXX[]X-------------------
-----------X[]----[[-----------------[]-----E-E->------------S-------------------------------------------------------]--
---E------XX[]----[]-----------------[]----]><><>-------------------------ooooooo-----------------------------------<>--
---------EXX[]----[]<---------------->S---[[X[]><-------------------------ooooooo-----------------------------------[]<-
--------<>XX[X--S-<X------Q><>>------[]----Q>QQQQ-------------------E----------->-----------------------------------[]--
-----E-X[]X]SQ--------XXX-[][E]------<>-------------------Q--------<[----------<]---->E----]E----------------------?SSS-
----<-XX[SXX[][----E--XXX-[][]-------------------------E------<]---[]-----E----[]----[X---->X<--------------------------
----[XXX[]XX[]-----E--XXX-X]X]------------------------<X-------]]--[X----<<----[E>-->[]----[]---------------------------
----[]XXX]XXXXXXXX<>[XXXX->XXXXXEXXXXXXX--------------[E------[]---[]----[-----[]---X[]<--X[>XXX---------E-E---E--------
----[]XXXXXXXXXXX][]-XXXX-XXXXXXXXXXXXXX---XXXXXXXXXXXXXX-XXX-X<--XXXXX--[]----[]----]----------------X><>XXXX<>XXX----X
----[>XXXXXXXXXXXX[]-XXXX-XXXXXXXXXXXXXX---XXXXXXXXXXXXXX-XXX-XX--XXXXX--[]----[]---------------------XX<>[XXX<XXXX----X