------------------------------------------------------------------------------------------------------------------------
------------------------------------------------------------------------------------------------------------------------
-XXXX-----------------SSSSSSSSSSSSSSSSS------------------------------------------------------------E--------------------
--[]------------------SSSSSSSS-------[]------------------------------------------------------ooo--<>--------------SSSSSS
--[]---------E--------SSSSSSSS-------[<------------------------------------------------------ooo--[][-------------------
--<>--------X]--?Q>QQ-SSSSSSSS-------[][--------------------------------X---XX-----X--------XXXXXX[]]-------------------
-----------X[S----[]----------------[[S----]E-E-E------------S-------------------------------------------------------E--
---E------XX[]----[]-----------------[]----<><><[-------------------------ooooooo-----------------------------------<[--
---------EXX[]----[]---------[-------[]----[]EQ[]-------------------------ooooooo-----------------------------------[]--
--------<>XX[]--S-[>------<>S<-------[]----]QQQQQ-------------------E----------]E-----------------------------------[---
-----E-X[]XX[Q--------XXX>[o<]-------<>-------------------Q---->---<>----------<>-----E-----E----------------------?<SS-
---<<>X[[]XXE]-----E--XXX-X][]<----------------------->E------<?---[]>----E----[]----<>----<>---------------------------
----[]XX[]XX[]-----E--XXX<[[[]------------------------<>------[o---[]----<>---][]----[]---<[]---------------------------
---->]XXXXXXXXXXXX<>-XXXX-XXXXXXEXXXXXXX--------------[X------[]---[]----[-----[]---[]?X--X[]XXX---------<-E---E--------
----[<XXXXXXXXXXXX[[-XXXX-XXXXXXXXXXXXXX---XXXXXXXXXXXXXX-XXX-X<--XXXXX-][]----[]---------------------XX<>XXXX-]XXX----X
---<[]XXXXXXXXXXXX[]-XXXX-XXXXXXXXXXXXXX---XXXXXXXXXXXXXX-XXX-XX--XXXXX--[]---<-]---------------------XX<>XXXX<>XXX----X