------------------------------------------------------------------------------------------------------------------------
------------------------------------------------------------------------------------------------------------------------
-XXXX-----------------SSSSSSSSSSSSSSSSS------------------------------------------------------------E--------------------
--[]------------------SSSSSSSS-------[]------------------------------------------------------ooo--<Q--------------SSSSSS
-<[?---------E--------SSSSSSSS-------?]------------------------------------------------------ooo-<X]--------------------
--<><-------<]--?QQQQ-SSSSSSSS-------E]---------------------------------X---XX-----X--------XXXXXX[]X-------------------
-----------X<X----[]-----------------[]-----E-E-E------------S-------------------------------------------------------E--
---E------XX[][---[]-----------------[Q----<>E><>-------------------------ooooooo-----------------------------------o>--
--------<>XX[]----[]--------><-------[]----[][][]-------------------------ooooooo-----------------------------------[]--
--------<>>X[X--S>E[------<><>-------[]----QQQQQQ-------------------E-----------E-----------------------------------[]--
-----[-X[]XX[]-----<--XXX-[][]-------S>-------------------Q-------]<>----------->-----E-----<----------------------?SSS-
----<>XX[<XX[]-----E--XXX-[][E------------------------>E-----<<o---[]-----E----]]----<>----<>---------------------------
----[]XXo]XXX]-----E--XXX-[][]------------------------<>------[]---[]----<>---->]<---<]----[]---------------------------
----[QXXXXXXXXXXXX<>-XXXX-XXX>XXEXXXXXXX-------------->]------[]---[]----[]--->[Q---X[]X--<[]XXX---------E-E---[--------
----[?XXXXXXXXXXXX[E-XXXX-XXXXXXXXXXXXXX---XXXXXXXXXXXXXX-XXX-XX--XXXXX--Q]----[Q---------------------XX<>XXXX]>XXX----X
---][]XXXXXXXXXXXX[Q-XXXX-XXXXXXXXXXXXXX---XXXXXXXXXXXXXX-XXX-XX--XXXXX--[>----[]---------------------XX<>XXXXS>XXX----X