------------------------------------------------------------------------------------------------------------------------
------------------------------------------------------------------------------------------------------------------------
-XXXX-----------------SSSSSSSSSSSSSSSSS------------------------------------------------------------E--------------------
--[]------------------SSSSSSSS-------[][-----------------------------------------------------ooo--<>--------------SSSSSS
--[]---------E--------SSSSSSSS-------[]------------------------------------------------------ooo--[]--------------------
--<>--------<>--?QQQQ-SSSSSSSS-------[]---------------------------------X---XX-----X--------XXXXXX[]X-------------------
---]-------X[]----[]-----------------[]-----E-E-]------------S-------------------------------------------------------E--
---E------XX[S<---?]-----------------[]----<-<>X>-------------------------ooooooo-----------------------------------<>--
---------EXX[]----[]-----------------[]----[][][]-------------------------ooooooo-----------------------------------[]--
-------[<o[X[]--S-<S-----<<><X-------[]----QQQQQQ-------------------E-----------E-----------------------------------[]--
-----E->[>XX[]--------XXX-[][]-------<>-------------------Q--------<>---------<<>---->E-----E----------------------?SSS-
----<>XX[QXX[>-----E--XXX-[][]------------------------[E-----<<>---[]-----E----[]----<>----<>---------------------------
----[SXX[]XX[[-----E--XXX-Q]o]------------------------S>------[]---[]----<Q----[?----[Q----[]---------------------------
----[]XXX<XXXXXXXX<>-XXXX-X<XXXXEXXXXXXX--------------[]------[]---[]----S]---<[<[--X[EX--X]]XXX---------E-E---E--------
----<]XXXXXXXXXXXX[]-XXXX-XXXXXXXXXXXXXX---XXXXXXXXXXXXXX-XXX-XX--XXXXX-[]]----[>]--------->----------XX<>XXXX<>XXX----X
----[]XXXXXXXXXXXX[]-XXXX-XXXXXXXXXXXXXX---XXXXXXXXXXXXXX-XXX-XX--XXXXX--[]----[]---------------------XXX>XXXX<>XXX----X