------------------------------------------------------------------------------------------------------------------------
------------------------------------------------------------------------------------------------------------------------
-XXXX-----------------SSSSSSSSSSSSSSSS>------------------------------------------------------------E--------------------
--[]------------------SSSSSSSS-------[<------------------------------------------------------ooo--->--------------SSSSSS
--[?---------E--------SSSSSSSS-------[]------------------------------------------------------ooo--[]--------------------
-->X--------<]--?QQQQ-SSSSSSSS-------[]---------------------------------X---XX-----X--------XXXXXX[]X-------------------
-----------X[]----[]-----------------[]-----E-<-E------------S------------------------------------>------------------E--
---E------X]>]----[]-----------------[?----?><><>]------------------------ooooooo-----------------------------------<>--
---------EXX[]----[]-----------------o]---[[o[]>]-------------------------ooooooo----------------------------------<[]--
--------<>XX[]<-S-<><-----<><>-------S]]---[QQQ[Q-------------------E-----------E-----------------------------------[X--
-----E-X[]XX[]--------XXX-[][--------<>-------------------Q--------<->---------]>-----E-----E----------------------?SSS-
----<>XX[]X][]-----E--XXX-?]X]-------------------------E------<>--[[]-----E----X]---[<>----E>---------------------------
----[]XX[][XX]-----E--XXX-[][]------------------------<>-----<[]---[]---[<>----[>-----]<---[]---------------------------
----[]XXXXXXXXXXXX<o-XXXX-XXXXXXEXXXXXXX--------------[]------[]---[]----[]----[]---X[]X--X[]XXX---------E-E---E--------
----[XXXXXXXXXXXXX[?-XXXX-XXXXXXXXXXXXXX---XXXXXXXXXXXXXX-XXX-XX--XXXXX--o]----[]---------------------XX<]XXXX<>XXX----X
----[[>XXXXXXXXXXX[]-XXXX-XXXXXXXXXXXXXX---XXXXXXXXXXXXXX-XXX-XX--XXXXX--[]----[]---------------------XX<>XXXX<o[XX----X