------------------------------------------------------------------------------------------------------------------------
------------------------------------------------------------------------------------------------------------------------
-XXXX-----------------SSSSSSSSSSSSSSSSS------------------------------------------------------------E--------------------
--o]------------------SSSSSSSS------[]?------------------------------------------------------ooo--<>--------------SSSSSS
-][]---------E--------SSSSSSSS-------[]------------------------------------------------------ooo--[]--------------------
--<>--------<>>-?QQQQ-SSSSSSSS--------[---------------------------------X---XX-----X--------XXXXXX[]X-------------------
-----------X[]----[]-----------------[]-----E-E-E------------S-------------------------------------------------------E--
---E------XX[]----E]-----------------[][---<><><?-------------------------ooooooo-----------------------------------<>--
---------EXX[]----[]-----------------[]<---]][][]-------------------------ooooooo-----------------------------------E]--
--------<>XX[<--S[<>------Q><>-------[?----QQQQQQ-------------------E-----------E-----------------------------------[E--
-----E-X[-XX[]--------XXX-[][]]------<>-------------------Q--------<>----------E>-----E-----E----------------------?S]S-
----<EXX[]XX[]]----E--XXX-[][][------------------------E------<>---]]-----E----[]----<>----<>---------------------------
----X>XXS>[X?]-----E--XXX<[]E]------------------------S>------[]<--[?----<>----[]---][X----[]---------------------------
----[]XXXXXX<XXXXX[--XXXX-XXXXXXEXXXXXXX-------------[[Q------[]--][]----[][---[]---XE]X--X[]XXX---------E-E---E--------
----[]XXXXXXXXXXXX[]-XXXX-XXXXXXXXXXXXXX---XXXXXXXXXXXXXX-XXX-XX--XXXXX--[]----[]---------------------XX<oXXXX<>XXX----X
----[]XXXXXXXXXXX][Q-XXXX-XXXXXXXXXXXXXX---XXXXXXXXXXXXXX-XXX-XX--XXXXX--E]---<[S[--------------------XX<>XXXX<XXXX----X