------------------------------------------------------------------------------------------------------------------------
------------------------------------------------------------------------------------------------------------------------
-XXXX-----------------SSSSSSSSSSSSSSSS]------------------------------------------------------------E--------------------
--[][-----------------SSSSSSSS-------[]------------------------------------------------------ooo--<X--------------SSSSSS
-[[]---------E--------SSSSSSSS------][]------------------------------------------------------ooo--[]--------------------
--X>--------<>--?QQQQ-SSSSSSSS-------<]---------------------------------X---XX-----X--------XXXXXX[]X-------------------
-----------X[]----[?-----------------[]>---]E-E-E------------S-------------------------------------------------------E--
---E------XX[]----S]-----------------[]----<>>><>]------------------------ooooooo-----------------------------------<>--
---------EX]?]----X>-----------------[Q>--<[][]oE[------------------------ooooooo-----------------------------------[]--
--------<>XXQ]--S-<>]-----<><]-------[]>---QQQ<QQ------------------<E-----------E-----------------------------------[]--
-----E-X[]XX[]--------XXX-Q-[]]------<<-------------------Q--------<>>---------<?-----E-----E----------------------?SSS-
----<>XX[]XXX]-----E--XXX-X][<-------------------------E------<>---[]----<]----[S----<>----<o---------------------------
----[]XX[]XX[]-----E--XXX-[][]------------------------<>----->[]---[]---<<>----E]----[]----[>---------------------------
----[]XXXXXXXXXXXX<>-XXXX-XXXXXXEXXXXXXX--------------[]------[]---E]----[]>---[]---X[]X--X[]XXX---------E-E--]E--------
----EQXXXXXXXXXXXX[]-XXXX-XXXXXXXXXXXXXX---XXXXXXXXXXXXXX-XXX-XX--XXXXX--[]----[X---------------------XX<>XXXX<>[XX----X
----[]XXXXXXXXXXXX[]-XXXX-XXXXXXXXXXXXXX---XXXXXXXXXXXXXX-XXX-XX--XXXXX--[>----[S---------------------XX<><XXX<>XXX----X