------------------------------------------------------------------------------------------------------------------------
------------------------------------------------------------------------------------------------------------------------
-XXXX-----------------SSSSSSSSSSSSSSSSS------------------------------------------------------------E--------------------
--[]------------------SSSSSSSS-------[]------------------------------------------------------ooo-><<--------------SSSSSS
--[E<--------E--------SSSSSSSS-------[o------------------------------------------------------ooo->[]--------------------
-<<o]-------<>--?QQQQ-SSSSSSSS------------------------------------------X---XX-----X--------XXXXXX[[X-------------------
-----------X[]----[]----------------[[]-----E-E-E------------S-------------------------------------------------------E--
---E------X<[]----S[[----------------[]----<><><>-------------------------ooooooo-----------------------------------<>[-
---------EXX[]--->[]-----------------[]<---[][][]-------------------------ooooooo----------------------------------[[]--
--------Q>XX[]>-S-<>------<><>-------[]----QQQQQQ-------------------E-----------E------------------------------------]>-
-----E-X[EXX[]--------XXX-[][]-------Q>-------------------Q--------<>----------<>-----E-----E----------------------?SSS-
----<>XX[QX>[[-----E--XXX-[][]]------------------------E------<>---[]-----E----[]----<>----<>---------------------------
----[]XX[]XX[]-----E--XXX-[][]------------------------<------>[]---[]----S>----Qo----[o----Q]---------------------------
----?]XXXXXXXXXXX<<>-XXXX-XXXXXXEXXXXXXX--------------[o------[]---X]----[]----[?---X[]X--X[]XXX---------E-E---E--------
----[]XXXXXXXXXXXX[]>XXXX-XXXXXXXXXXXXXX---XXXXXXXXXXXX[X-XXX-X<--X>]XX-][]----[]---------->----------XX<>XXXX<>XXX----X
----[?XXXXXXXXXXXX[?-XXXX-XXXXXXXXXXXXXX---XXXXXXXXXXXXXX-XXX-XX--XXXXX--[]----[>---------------------XX<>XXXX<>XXX----X