------------------------------------------------------------------------------------------------------------------------
------------------------------------------------------------------------------------------------------------------------
-XXXX-----------------SSSSSSSSSSSSSSSSS------------------------------------------------------------E--------------------
--[?------------------SSSSSSSS------][]------------------------------------------------------ooo-[<>--------------SSSSSS
--[]---------E--------SSSSSSSS-------[]------------------------------------------------------ooo--[]]-------------------
--o>--------<>--?QQQQ-SSSSSSSS-------[][--------------------------------X---XX-----X--------XXXXXX[]X-------------------
-----------X[]----<]----------------][]<----<-E-E------------S-------------------------------------------------------E--
---E------XX[]---][]-----------------[]----<><>[>-------------------------ooooooo-----------------------------------<>--
--------]EXX[]----[]-----------------[-----[<X][]-------------------------ooooooo-----------------------------------?<>-
--------<>XX[]--S-<>------<>X>-------[]----QQQQQQ-------------------E-----------E-----------------------------------[]--
-----E-X[]XX[]--------XXX-[][]-------<>>------------------Q--------<>----------<------E-----E----------------------?S<S-
----<>X][SXX[]-----E--XXX-[][]-------[-----------------E------<>---[]-----E----[]----<>----<<]--------------------------
----[]X>[]XX[[---->E--XXX-[][E------------------------<>------[]---o]----<>----[-----[]----[S---------------------------
----[<XXXXXXXXXXXX<>-XXXX-X]XXXXEXXXXXXX--------------[]------E]---[[---<[]----[]---X[]X--X[]XXX---------E-E---E--------
----[XXXXXXXXXXXXX[]-XXXX-XXXXXXXXXXXXXX---XXXXXXXXXXXXXX-XXX-XX--X]XXX--[]----]]---------->----------XX<>>XXX<oXXX----X
---<[]XXXXXXXXXXXX[]-XXXX-XXXXXXXXXXXXXX---XXXXXXXXXXXXXX-XXX-XX--XXXXX--[]----[]---------------------XX<>XXXX<>XXX----X